A2 0 2 A1 B2
A1 0 1 B1 A2  
B1 1 1 A1 C1  
B2 1 2 A2 C2
C1 2 1 B1 D1
C2 2 2 B2 D2
D1 3 1 C1 E1
D2 3 2 C2 E2
E1 4 1 D1 F1
E2 4 2 D2 F2
F1 5 1 E1
F2 5 2 E2 F3
F3 5 3 F2
mad scientest D2
Exit F3
